R 1920 1080
NO ./xpm/pioneer.xpm
SO ./xpm/greenwall.xpm
WE ./xpm/bookwall.xpm
EA ./xpm/wall.xpm
S ./xpm/mana_60.xpm
C 37,44,58
F 88,88,96


111111111111111
100000000100021
1011101101011111111
1012101000000012101
1000101111101010101
1111101002101010101
   1001101101010101
   1000000001000001
1111010110111110101
10210101000S0010101
1011010111101011111
100001010000101
111111010111111
120000010021
111111111111