R 1920 1080
F 126,201,36
NO ./xpm/aln.xpm
SO ./xpm/als.xpm
WE ./xpm/alw.xpm
EA ./xpm/al.xpm
S ./xpm/pupier.xpm
C 225,30,0


111111111111111
100000000100021
1011101101011111111
1012101000000012101
1000101111101010101
1111101002101010101
   1001101101010101
   1000000001000001
1111010110111110101
10210101000S0010101
1011010111101011111
100001010000101
111111010111111
120000010021
111111111111