R 1920 1080
NO ./xpm/pioneer.xpm
SO ./xpm/greenwall.xpm
WE ./xpm/bookwall.xpm
EA ./xpm/wall.xpm
S ./xpm/mana_60.xpm
C 37,44,58
F 88,88,96

1111111111
1000000001
1000N00001
100000N001
1111111111