R 1920 1080
NO ./xpm/pioneer.xpm
SO ./xpm/greenwall.xpm
WE ./xpm/bookwall.xpm
EA ./xpm/wall.xpm
S ./xpm/mana_60.xpm
C 37,44,58
F 88,88,96

1111111111111111111111111111111111111111111
1200100000000010101010000000100010000010121
1110101111101010101010111011111011101110101
1000101000001010001000100010100010100010001
1110111011111110111111111010111010101011101
1000000000001000100000100010000010001010001
1110111110111110101111111011101111111011101
1010101010001000001000100020001000001000001
1010101010111011101010101011111110111110111
1000101000000000100010001000100000001000001
1111101110111011101011101011111111101010111
1010000000001010101000101010101000200010101
1010101111111010101110101110101011111011101
1010100000001010000010100000101010101000101
1010111111101111101111111110101010101011101
1000100000001010000000001000100010000000001
1111111111101011111011111111101110111111101
100010000010000010001S100000100010001000001
1110101110111110111110110111111111101111101
1200100010100000000002100000000000101000001
1110111110101111101111111111101111101111101
1000100010101000100000001000000010000010101
1110101110111011101111111010111111111010101
1000001000001000000000001010000010001010001
1110111011111111101111111111101110101011101
1000000000020000001010000000001000101210001
1110111011111110101010111111111110111011101
1010100000001010100010000000101000100000101
1011111010111011111010101010101011101110111
1000000010000010101010101010000000000010001
1111101111101010101010111111111110101011111
1000000010101000201000100000100010101000001
1010101110111111111010111010101110111010111
1010100000000000001010100010000000001010001
1010101011101111111111101010111011111110111
1010101000101000101010001010101000100010001
1011101111101011101011111011101110101010111
1000101000000000001010100000100010001010001
1011101110111111101010101011111010101110111
1010001000001000001000101000000010101000001
1110111010111010111011111111111010111010101
1200001010001010000000000000100010001010121
1111111111111111111111111111111111111111111