  R 1920     1080  
NO ./north_texture         
SO ./south_texture
WE             ./west_texture
      
EA ./east_texture
      

S ./sprite_texture           
C 225,30,0     
F                                                  126,201,36
        
    
1111111111
1000210001
1010110101
1110000101
1011111201
10000N1101
1011101001
1010100011
1010001001
1111111111